1100000000
0111111000
0000001000
1111101000
0000101110
0000100010
0000110001
000001x000
0000011100
0000000111